000000000000000000000
000000000000000000000
000000000000000000020
000000000000000000020
000000000000000000010
000000000000000000010
000000000000000000040
100000000000000000010
100000000000000000010
101011001010010100110
